120
14
26 0 0 0 0 0 0 0 0 4 5 5 6 0 0 0 0 0 0 0 0 0 0 0 0 0 0 0 4 5 6 0 0 0 0 0 0 0 0 0 0 0 0 0 0 0 4 5 6 0 0 23 24 24 24 25 0 4 5 5 5 6 0 0 0 0 0 0 0 0 0 0 0 0 0 0 0 0 4 5 5 5 5 5 5 5 5 5 5 5 5 5 5 5 5 5 6 0 0 0 0 0 0 0 0 0 0 0 0 0 0 0 0 0 0 0 0 0 0 27 
26 0 0 0 0 0 0 0 0 0 0 0 0 0 0 0 0 0 0 0 0 0 0 0 0 0 0 0 0 0 0 0 0 0 0 0 0 0 0 0 0 0 0 0 0 0 0 0 0 0 0 27 19 19 19 26 0 0 0 0 0 0 0 0 0 0 0 0 0 0 0 0 0 0 0 0 0 0 0 0 0 0 0 0 0 0 0 0 0 0 0 0 0 0 0 0 0 0 0 0 0 0 0 0 0 0 0 0 0 0 0 0 0 0 0 0 0 0 0 27 
26 0 0 0 0 0 0 0 0 0 0 0 0 0 0 0 0 0 0 0 0 0 0 0 0 0 0 0 0 0 0 0 0 0 0 0 0 0 0 0 0 0 0 0 0 0 0 0 0 0 0 27 19 19 19 26 0 0 0 0 0 0 0 0 0 0 0 0 0 0 0 0 0 0 0 0 0 0 0 0 0 0 0 0 0 0 0 0 0 0 0 0 0 0 0 0 0 0 0 0 0 0 0 0 0 0 0 0 0 0 0 0 0 0 0 0 0 0 0 27 
26 13 12 11 12 14 0 0 0 0 0 0 0 0 0 0 0 13 11 14 0 0 0 0 0 0 0 0 0 0 0 0 0 0 0 0 0 0 0 0 0 0 0 0 23 24 25 0 0 0 0 20 21 18 21 22 0 0 0 0 0 0 0 0 0 0 0 0 0 0 0 0 0 0 0 0 0 0 0 0 4 5 5 5 5 6 0 0 0 0 4 5 5 6 0 0 23 24 24 24 24 24 25 0 0 0 0 0 0 0 0 0 0 0 0 0 0 0 0 27 
26 0 0 45 0 0 0 0 0 0 0 0 0 0 0 0 0 0 44 0 0 0 0 0 0 0 0 0 0 0 0 0 0 0 0 0 0 0 0 0 0 0 0 0 20 18 22 0 0 0 0 0 0 55 0 0 0 0 0 0 0 0 0 0 0 0 0 0 0 0 0 0 0 0 0 0 0 0 35 0 0 0 0 0 0 0 4 16 6 0 0 0 0 0 0 23 19 21 21 21 21 21 19 25 0 0 0 0 0 0 0 0 0 0 0 0 0 0 0 27 
26 0 0 45 0 0 0 0 0 0 0 0 0 0 0 0 0 0 44 0 0 0 61 0 0 0 0 0 0 0 0 0 0 0 0 0 0 0 0 0 0 0 0 0 0 55 0 23 24 25 0 0 0 53 0 0 0 0 0 0 0 0 0 0 0 0 0 0 0 0 0 0 0 0 0 0 0 0 0 0 0 0 0 0 0 0 0 16 0 0 0 0 0 0 0 20 22 51 48 49 47 0 20 22 0 23 24 24 24 25 0 0 0 0 0 0 0 0 0 27 
26 0 0 45 0 0 0 0 0 0 0 0 0 0 0 0 0 0 43 0 0 0 35 0 0 0 0 0 0 0 0 0 0 0 0 0 0 0 0 0 0 0 0 0 0 53 0 20 18 22 0 0 0 54 0 0 0 0 0 0 0 0 0 0 0 0 0 0 0 0 0 0 35 0 0 35 0 0 0 0 0 0 0 0 0 0 0 16 0 0 0 0 0 0 0 0 0 0 0 0 54 52 0 0 23 19 21 18 21 19 25 0 0 0 0 0 0 0 0 27 
26 0 0 45 0 0 0 0 0 0 0 0 0 0 35 0 0 3 2 1 0 0 0 0 0 0 0 0 0 0 0 0 0 0 0 0 0 0 0 0 0 0 0 0 0 54 0 0 53 0 0 0 0 53 0 0 23 24 25 0 0 0 0 0 0 0 0 0 0 35 0 0 0 0 0 0 0 0 0 0 0 0 0 0 0 0 0 16 0 0 0 0 0 0 0 0 0 0 0 0 55 48 52 0 20 22 50 47 0 20 22 0 0 0 0 0 0 0 0 27 
26 0 0 45 0 0 0 0 0 0 40 0 61 0 0 0 0 0 0 0 0 0 35 0 0 61 64 0 0 0 0 0 0 0 0 0 0 0 0 0 0 0 0 0 0 53 0 0 55 0 0 0 0 53 0 0 20 18 22 0 0 0 0 0 0 0 35 0 0 0 0 0 0 0 0 0 0 0 0 0 0 0 0 0 0 0 0 16 0 0 0 0 0 0 0 0 0 0 0 0 53 0 0 0 0 0 0 53 0 0 0 0 0 0 0 0 0 0 0 27 
26 0 0 45 0 0 0 0 0 0 31 32 33 0 0 0 0 0 0 0 0 0 0 0 32 33 0 0 58 0 0 0 0 0 0 0 0 0 0 0 0 0 0 0 0 53 0 0 47 0 0 0 0 53 0 0 0 53 0 0 0 0 0 0 0 0 0 0 0 0 0 0 0 0 0 0 0 0 0 0 0 0 0 0 0 0 0 16 0 0 0 0 0 0 0 0 0 0 0 0 47 0 0 0 0 0 0 53 0 0 0 32 0 0 0 0 0 0 0 27 
26 0 0 45 0 56 0 0 57 31 8 8 9 0 0 0 0 0 0 0 0 0 0 0 8 8 10 0 0 0 0 0 0 0 0 0 0 0 0 0 0 0 0 0 0 53 0 0 47 0 0 0 0 53 0 0 0 55 0 0 0 0 0 0 35 0 0 0 0 0 0 0 0 0 0 0 0 0 0 0 0 0 0 0 0 0 0 16 0 0 0 0 0 0 0 0 0 0 51 48 55 48 52 0 0 0 0 54 49 52 32 8 0 0 0 0 0 0 0 27 
26 0 0 45 0 13 11 14 0 7 8 8 9 0 0 0 0 0 0 0 0 0 0 0 8 8 8 10 0 0 0 0 0 0 0 0 0 0 0 0 0 0 0 0 38 46 40 0 46 38 0 0 0 46 0 38 0 46 38 0 0 40 0 0 0 0 0 0 0 0 0 0 0 0 0 0 0 0 0 0 0 0 0 0 0 0 0 17 0 0 0 0 0 0 0 0 0 0 0 0 53 0 0 0 0 0 0 47 0 0 8 8 0 0 0 0 0 0 0 27 
26 61 0 43 61 0 43 0 0 7 8 8 9 0 0 0 0 0 0 0 0 0 61 31 8 8 8 9 0 0 0 0 0 0 0 0 0 0 0 31 33 0 0 0 31 32 32 32 32 32 32 32 32 32 32 32 32 32 32 32 32 32 32 10 29 29 29 29 29 29 29 29 29 29 29 29 29 29 29 29 28 28 28 28 28 28 28 30 29 29 29 29 29 29 28 33 0 0 0 0 47 23 24 24 24 24 25 47 0 31 8 8 0 0 0 0 61 0 0 27 
31 32 32 32 32 32 32 32 32 7 8 8 9 29 29 29 29 29 29 29 29 29 31 8 8 8 8 9 28 28 34 28 28 34 29 29 34 29 29 7 9 29 29 29 7 8 8 8 8 8 8 8 8 8 8 8 8 8 8 8 8 8 8 9 30 30 30 30 30 30 30 30 30 30 30 30 30 30 30 30 30 30 30 30 30 30 30 30 30 30 30 30 30 30 30 9 23 24 24 25 53 27 19 19 19 19 26 53 0 7 8 8 32 32 32 32 32 32 32 33 
