76
18
0 0 0 0 0 0 0 0 0 0 0 0 0 0 0 0 0 0 0 0 0 0 0 0 0 0 0 0 0 0 0 0 0 0 0 0 0 0 0 0 0 0 0 0 0 0 0 0 0 0 0 0 0 0 0 0 0 0 0 0 0 0 0 0 0 0 0 0 0 0 0 0 0 0 0 63 
0 0 0 0 0 0 0 0 0 0 0 0 0 0 0 0 0 0 0 0 0 0 0 0 0 0 0 0 0 0 0 0 0 0 0 0 0 0 0 0 0 0 0 0 0 0 0 0 0 0 0 0 0 0 0 0 0 0 0 0 0 0 0 0 0 0 0 0 0 0 0 0 0 0 0 63 
0 0 0 0 0 0 0 0 0 0 0 0 0 0 0 0 0 0 0 0 0 0 0 0 0 0 0 0 0 0 0 0 0 0 0 0 0 0 0 0 0 0 0 0 0 0 0 0 0 0 0 0 0 0 0 0 0 0 0 0 0 0 0 0 0 0 0 0 0 0 0 0 0 0 0 63 
0 0 0 0 0 0 0 0 0 0 0 0 0 0 0 0 0 0 0 0 0 0 0 0 0 0 0 0 0 0 0 0 0 0 0 0 0 0 0 0 0 0 0 0 0 0 0 0 0 0 0 0 0 0 0 0 40 41 42 0 0 0 0 0 0 0 0 0 40 41 41 41 41 41 42 63 
0 0 0 0 0 0 0 0 0 0 0 0 0 0 0 0 0 0 0 0 0 0 0 0 0 0 0 0 0 0 0 0 0 0 0 4 0 0 0 0 0 0 0 0 0 0 0 0 0 0 0 0 0 0 0 0 0 0 0 0 0 0 0 0 0 0 0 0 0 0 0 0 0 0 0 63 
52 47 47 47 47 47 47 50 0 0 0 0 0 0 0 0 0 0 0 0 0 0 0 0 0 0 0 0 0 0 0 0 0 0 40 41 41 41 41 41 41 41 41 42 0 0 0 0 0 0 0 0 0 0 0 0 4 0 0 0 0 0 0 0 0 0 0 0 0 0 0 0 0 0 0 63 
52 8 8 8 9 9 9 0 0 0 0 0 0 0 0 0 0 0 0 0 0 0 0 0 0 0 0 0 0 0 0 0 0 0 0 0 0 0 0 0 0 0 0 0 0 0 0 40 41 41 42 0 59 60 60 60 61 0 0 0 0 0 40 42 0 0 0 0 0 0 0 0 0 0 0 63 
52 8 8 8 9 9 9 0 0 0 0 0 0 0 0 0 0 0 0 0 0 0 0 0 0 0 0 0 0 0 0 0 0 0 0 0 0 0 0 0 0 0 0 0 0 40 42 0 0 0 40 42 63 55 55 55 62 0 0 0 0 0 0 0 0 0 59 60 60 60 60 61 0 0 59 55 
52 8 8 8 9 9 9 0 0 0 0 0 0 0 0 0 0 0 0 0 0 0 0 0 0 0 0 0 0 0 0 0 0 0 0 0 0 0 0 0 0 0 40 41 42 0 0 0 0 0 0 59 55 57 54 57 55 61 0 0 0 0 0 0 0 59 55 55 55 55 55 55 61 59 55 55 
52 8 8 8 8 9 9 0 0 0 0 0 0 0 0 0 0 0 0 0 0 0 0 0 0 0 0 0 0 0 0 0 0 0 0 40 41 41 51 41 41 42 0 0 0 0 0 0 0 0 0 56 58 0 17 0 56 58 0 0 59 60 60 60 61 63 55 55 55 55 55 55 62 63 55 55 
52 8 8 8 8 9 9 0 0 0 0 0 0 0 0 0 0 0 0 0 0 0 0 0 0 0 0 0 0 4 0 0 71 0 0 0 0 0 52 0 0 0 0 0 40 41 41 42 0 0 0 0 0 0 17 0 0 0 40 42 63 55 55 55 62 63 55 55 55 55 55 55 62 56 55 55 
52 8 8 8 8 9 9 0 0 0 0 0 0 0 0 0 0 0 0 0 0 0 0 0 0 0 0 0 0 71 0 0 0 0 0 0 0 0 52 0 0 0 0 0 0 0 0 0 0 0 0 0 0 0 17 0 0 0 0 0 56 57 54 57 58 63 57 54 55 55 55 55 62 0 56 54 
52 8 8 8 8 9 9 0 0 0 0 0 0 0 0 0 0 0 0 0 0 0 0 2 0 0 71 0 0 0 0 0 0 0 0 0 0 0 52 0 0 0 0 0 0 0 0 0 0 0 0 0 0 0 17 0 0 0 0 0 0 15 11 0 0 0 0 17 56 55 55 55 62 0 0 18 
52 8 8 8 8 9 9 0 0 0 0 0 0 0 0 0 0 0 0 0 0 0 67 68 69 0 0 0 0 0 3 0 0 0 0 4 0 0 53 0 0 0 0 0 0 0 0 0 0 0 0 0 0 0 19 0 0 0 0 0 0 0 17 0 0 0 0 17 0 56 54 58 0 0 0 18 
52 8 8 8 8 9 9 0 0 0 0 0 0 0 0 0 0 0 0 0 2 25 43 44 45 64 64 64 64 64 39 38 38 38 38 37 65 65 66 64 64 64 64 64 64 64 64 64 64 64 64 64 64 46 19 0 0 0 0 0 0 0 19 16 0 0 0 17 0 0 17 0 0 0 0 18 
52 8 8 8 8 9 9 20 0 4 25 0 22 0 0 0 0 0 0 0 67 68 44 44 45 66 66 66 66 66 66 66 66 66 66 66 66 66 66 66 66 66 66 66 66 66 66 66 66 66 66 66 66 45 17 0 0 0 0 0 0 0 17 0 0 0 0 17 0 0 17 0 0 0 15 19 
52 7 8 7 7 9 7 25 0 67 46 0 0 0 0 2 0 25 2 0 43 44 44 44 45 66 66 66 66 66 66 66 66 66 66 66 66 66 66 66 66 66 66 66 66 66 66 66 66 66 66 66 66 45 11 0 0 0 0 0 0 0 17 0 0 0 0 17 0 0 17 0 0 0 0 18 
53 68 68 68 68 68 68 68 68 43 45 64 64 64 64 67 68 68 68 69 43 44 44 44 45 66 66 66 66 66 66 66 66 66 66 66 66 66 66 66 66 66 66 66 66 66 66 66 66 66 66 66 66 45 11 26 26 26 26 26 26 26 17 26 26 26 26 17 26 26 17 26 26 26 26 10 
