135
15
70 70 70 70 70 70 70 70 70 60 61 61 61 61 61 61 61 61 61 61 62 70 71 0 0 0 0 0 0 0 0 0 0 0 63 62 66 67 67 68 70 66 68 70 60 64 64 64 64 64 61 62 70 70 70 70 81 81 81 92 87 87 87 87 87 87 87 87 87 87 87 87 87 87 87 87 87 87 88 0 0 0 0 0 0 83 85 0 0 0 0 0 0 0 0 0 0 0 0 0 0 108 109 109 109 109 109 109 109 110 0 0 0 0 0 0 0 0 0 0 0 0 0 0 0 0 0 0 0 0 0 0 0 0 103 
70 70 70 70 70 70 70 70 60 65 0 0 21 0 0 0 0 21 0 0 63 61 65 0 0 0 0 0 0 0 0 0 0 0 0 63 62 70 70 70 60 61 61 61 65 0 0 0 0 21 0 69 70 70 70 70 81 81 81 96 0 0 0 0 0 0 0 0 0 0 0 0 0 0 0 21 0 0 0 0 0 0 0 0 0 0 0 0 0 0 0 0 0 0 0 0 0 0 0 0 0 0 0 0 0 0 0 0 0 0 0 0 0 0 97 98 98 99 0 0 0 0 0 0 0 0 0 0 0 0 0 0 0 0 103 
70 70 70 70 70 70 70 60 65 0 0 0 0 0 0 0 0 0 0 0 0 0 21 0 0 0 0 0 0 0 0 0 0 0 0 0 63 64 64 64 65 0 0 0 21 0 0 0 0 10 0 69 70 70 70 70 81 81 81 96 0 0 0 0 0 0 0 0 83 85 0 0 0 0 0 0 10 0 0 0 0 0 0 0 0 0 0 0 0 0 0 0 0 0 0 0 0 0 0 0 0 0 0 0 0 0 0 0 0 0 0 0 0 0 103 104 104 105 0 0 0 0 0 0 0 0 0 0 0 0 0 0 0 0 103 
70 70 70 61 61 61 61 65 0 0 0 0 0 0 0 0 0 0 0 0 0 0 0 0 0 0 0 0 0 0 0 0 0 0 0 0 0 0 21 0 0 0 0 0 0 0 0 0 57 59 0 69 70 70 70 70 81 81 81 96 0 0 0 0 0 0 0 0 0 21 0 0 0 0 0 0 77 78 79 0 0 0 0 0 0 0 0 0 0 0 0 0 0 0 83 85 0 0 0 0 0 0 0 97 112 112 112 99 0 0 0 0 0 0 108 101 101 110 0 0 0 97 99 0 0 0 0 0 0 0 16 0 0 0 103 
70 70 65 0 0 0 21 0 0 0 0 0 0 0 0 0 0 0 0 0 0 0 0 0 0 0 0 0 0 0 0 0 0 0 0 0 0 0 0 0 0 0 0 0 0 0 12 57 68 72 0 69 70 70 70 81 81 81 81 96 0 0 0 0 83 84 85 0 0 0 0 0 0 83 85 0 80 81 82 0 0 0 0 0 0 83 84 85 0 0 83 85 0 0 0 0 0 0 83 84 85 0 0 103 97 98 99 105 0 0 0 0 0 0 0 0 0 0 0 0 0 108 111 99 0 0 0 0 97 98 98 98 99 0 103 
60 65 0 0 0 0 0 0 0 0 0 0 0 0 0 0 0 0 0 12 13 0 0 0 0 0 0 0 0 0 0 0 0 0 0 0 0 0 0 0 0 0 17 12 12 12 57 68 70 72 0 69 70 70 81 81 81 81 81 96 0 0 0 0 0 0 0 0 0 0 0 0 0 0 0 0 80 81 89 79 0 0 0 0 0 0 0 0 0 0 0 0 0 0 0 0 0 0 0 0 0 0 0 103 103 104 105 105 0 0 97 99 0 0 0 0 0 0 0 0 0 0 108 110 0 0 0 97 113 104 104 104 111 99 103 
72 0 0 0 0 0 0 0 0 0 0 0 0 0 0 0 0 0 0 74 76 0 0 0 0 0 0 0 0 0 0 0 0 0 0 0 0 0 0 0 0 0 57 67 58 59 69 70 70 72 0 69 70 70 81 81 81 81 81 96 0 0 0 0 0 0 0 0 0 83 85 0 0 0 0 0 80 81 81 82 0 0 0 0 0 0 0 0 0 0 0 0 0 0 83 85 0 0 0 0 0 0 0 103 108 109 110 105 0 0 108 110 0 0 0 0 97 112 99 0 0 0 0 0 0 0 0 108 109 109 109 109 109 110 103 
72 0 0 0 0 0 0 0 0 0 0 0 3 0 0 0 17 17 0 0 0 0 0 0 0 0 0 0 0 0 0 0 0 0 0 0 10 15 13 17 0 0 73 66 68 71 69 70 70 72 0 69 70 70 81 81 81 81 81 96 0 0 0 0 0 0 0 0 0 21 0 0 0 0 0 0 80 81 81 89 79 0 0 0 83 85 0 0 0 0 0 0 0 0 0 0 0 0 0 0 0 0 0 108 109 109 109 110 0 0 0 0 0 0 0 0 103 104 105 0 0 0 0 0 97 98 99 0 0 0 0 0 0 0 103 
72 0 0 0 0 0 0 0 0 0 0 0 10 0 0 0 74 76 0 0 0 0 0 0 0 0 0 0 0 0 0 0 0 0 0 0 57 75 75 59 0 0 73 70 70 71 69 70 70 72 0 69 70 81 81 81 81 81 81 96 0 0 0 0 0 83 85 0 0 0 0 0 0 0 83 85 80 81 81 81 82 0 0 0 0 0 0 0 0 0 0 0 0 0 0 0 0 0 0 0 83 85 0 77 79 0 0 0 0 0 0 0 0 0 97 98 103 104 105 97 99 0 0 0 108 109 110 0 0 0 0 0 0 0 103 
72 0 0 0 0 0 0 0 0 0 0 0 57 0 0 0 0 0 0 0 0 0 0 0 0 0 0 0 0 0 0 0 12 13 13 0 69 70 70 71 12 12 73 70 70 71 73 77 78 79 0 77 90 90 90 90 90 90 90 91 0 0 0 0 0 0 0 0 0 0 0 0 0 0 0 0 80 81 81 81 89 79 0 0 0 0 0 0 0 0 0 83 85 0 0 0 0 0 0 0 0 0 0 80 95 0 0 0 0 0 0 0 0 97 101 110 108 101 110 108 110 0 0 97 99 0 0 0 0 0 0 0 0 0 103 
71 0 1 0 0 0 0 0 0 2 0 57 68 8 8 8 8 8 8 59 0 5 0 4 0 0 0 0 0 0 0 0 57 58 59 0 69 70 70 71 57 58 70 70 70 71 73 80 81 82 0 86 87 87 87 87 87 87 87 87 0 0 0 77 79 0 0 0 0 0 83 85 0 0 0 0 96 81 81 81 81 89 78 78 78 79 0 0 83 85 0 0 0 0 0 0 0 0 0 0 9 0 0 80 95 0 97 99 0 0 0 0 97 105 0 0 0 0 0 0 0 0 0 108 110 0 0 0 0 0 0 0 0 0 103 
71 12 12 12 10 12 12 14 15 14 15 69 66 8 8 8 8 8 8 71 12 12 0 13 0 12 13 12 12 12 12 19 69 70 71 0 69 70 70 71 69 70 70 70 70 71 69 80 81 82 0 0 0 0 0 0 0 0 0 0 0 77 78 81 95 0 0 0 0 0 0 0 0 83 85 0 80 81 81 81 81 81 81 81 81 82 0 0 0 0 0 0 0 0 0 0 0 0 0 77 78 78 79 80 95 99 108 110 0 0 0 0 103 111 99 0 0 0 0 0 0 97 99 0 0 0 0 0 0 0 0 0 0 0 103 
66 67 67 67 67 67 67 67 67 67 67 68 70 70 70 70 70 66 70 66 67 67 67 67 67 67 67 67 67 67 67 67 68 70 71 58 68 70 70 71 69 70 70 70 70 66 68 80 81 89 78 78 78 78 78 78 78 78 78 78 78 91 81 81 89 79 0 0 0 0 0 0 0 0 0 0 80 81 81 81 81 81 81 81 81 89 78 78 78 78 78 78 78 78 78 78 78 78 78 91 81 81 82 80 95 111 98 98 98 98 98 98 113 104 105 0 0 0 0 0 0 108 110 0 0 0 0 0 0 0 0 0 0 0 103 
70 70 70 70 70 70 66 70 70 70 60 70 70 70 62 70 60 70 70 70 66 70 70 70 70 70 70 70 70 70 70 70 70 70 71 70 60 61 62 72 69 70 60 61 61 61 62 80 84 87 87 87 87 87 87 87 87 87 87 87 87 87 87 87 87 89 78 78 78 78 78 78 78 78 78 78 91 81 81 81 81 81 81 81 81 81 81 81 81 81 81 81 81 81 81 81 81 81 81 81 81 81 82 80 95 104 104 104 104 104 104 104 104 104 111 98 98 98 98 98 98 98 98 98 98 98 98 98 98 98 98 98 98 98 98 
0 0 0 0 0 0 0 0 0 0 0 0 0 0 0 0 0 0 0 0 0 0 0 0 0 0 0 0 0 0 0 0 0 0 0 0 0 0 0 0 0 0 0 0 0 0 0 0 0 0 0 0 0 0 0 0 0 0 0 0 0 0 0 0 0 0 0 0 0 0 0 0 0 0 0 0 0 0 0 0 0 0 0 0 0 0 0 0 0 0 0 0 0 0 0 0 0 0 0 0 0 0 0 0 0 0 0 0 0 0 0 0 0 0 0 0 0 0 0 0 0 0 0 0 0 0 0 0 0 0 0 0 0 0 0 
