41
15
70 70 70 70 70 70 70 70 70 60 61 61 61 61 61 61 61 61 61 61 62 70 71 0 0 0 0 0 0 0 0 0 0 0 0 0 0 0 0 0 0 
70 70 70 70 70 70 70 70 60 65 0 0 21 0 0 0 0 21 0 0 63 61 65 0 0 0 0 0 0 0 0 0 0 0 0 0 0 0 0 0 0 
70 70 70 70 70 70 70 60 65 0 0 0 0 0 0 0 0 0 0 0 0 0 21 0 0 0 0 0 0 0 0 0 0 0 0 0 0 0 0 0 0 
70 70 70 61 61 61 61 65 0 0 0 0 0 0 0 0 0 0 0 0 0 0 0 0 0 0 0 0 0 0 0 0 0 0 0 0 0 0 0 0 0 
70 70 65 0 0 0 21 0 0 0 0 0 0 0 0 0 0 0 0 0 0 0 0 0 0 0 0 0 0 0 0 0 0 0 0 0 0 0 0 0 0 
60 65 0 0 0 0 0 0 0 0 0 0 0 0 0 0 0 0 0 12 13 0 0 0 0 0 0 0 0 0 0 0 0 0 0 0 0 0 0 0 0 
72 0 0 0 0 0 0 0 0 0 0 0 0 0 0 0 0 0 0 74 76 0 0 0 0 0 0 0 0 0 0 0 0 0 0 0 0 0 0 0 0 
72 0 0 0 0 0 0 0 0 0 0 0 3 0 0 0 17 17 0 0 0 0 0 0 0 0 0 0 0 0 0 0 0 0 0 0 0 0 0 0 0 
72 0 0 0 0 0 0 0 0 0 0 0 10 0 0 0 74 76 0 0 0 0 0 0 0 0 0 0 0 0 0 0 0 0 0 0 0 0 0 0 0 
72 0 0 0 0 0 0 0 0 0 0 0 57 0 0 0 0 0 0 0 0 0 0 0 0 0 0 0 0 0 0 0 12 13 13 0 0 0 0 0 0 
71 0 1 0 0 0 0 0 0 2 0 57 68 8 8 8 8 8 8 59 0 5 0 4 0 0 0 0 0 0 0 0 57 58 59 0 0 0 0 0 0 
71 12 12 12 10 12 12 14 15 14 15 69 66 8 8 8 8 8 8 71 12 12 0 13 0 12 13 12 12 12 12 19 69 70 71 0 0 0 0 0 0 
66 67 67 67 67 67 67 67 67 67 67 68 70 70 70 70 70 66 70 66 67 67 67 67 67 67 67 67 67 67 67 67 68 70 71 0 0 0 0 0 0 
70 70 70 70 70 70 66 70 70 70 60 70 70 70 62 70 60 70 70 70 66 70 70 70 70 70 70 70 70 70 70 70 70 70 71 0 0 0 0 0 0 
0 0 0 0 0 0 0 0 0 0 0 0 0 0 0 0 0 0 0 0 0 0 0 0 0 0 0 0 0 0 0 0 0 0 0 0 0 0 0 0 0 
